柏木 壮亮=Kashiwagi Sousuke
柏木=Kashiwagi
壮亮=Sousuke
そうちゃん=Sou-chan
北条 ロイ=Houjou Roy
北条=Houjou
ロイ=Roy
近藤 拓磨=Kondo Takuma
近藤=Kondo
拓磨=Takuma
春野 千佳=Haruno Chika
春野=Haruno
千佳=Chika
ちかりん=Chikarin
高岡 結香=Takaoka Yuika
高岡=Takaoka
結香=Yuika
ユイ=Yui
三枝 葵=Saigusa Aoi
三枝=Saigusa
葵=Aoi
アオイ=Aoi
大鳥 由菜=Ootori Yuna
大鳥=Ootori
由菜=Yuna
ユナ様=Yuna-sama
奥田 実咲=Okuda Misaki
奥田=Okuda
実咲=Misaki
みさきち=Misakichi
磯部 沙菜=Isobe Sana
磯部=Isobe
沙菜=Sana
サナ=Sana
横井 柚葉=Yokoi Yuzuha
横井=Yokoi
柚葉=Yuzuha
ユズハ=Yuzuha
和泉 里穂=Izumi Riho
和泉=Izumi
里穂=Riho
りほ=Riho
梅田 優里=Umeda Yuuri
梅田=Umeda
優里=Yuuri
ユーリ=Yuuri
羽田 絵里=Haneda Eiri
羽田=Haneda
絵里=Eiri
はたえり=Hataeri
本間 幸恵=Honma Yukie
本間=Honma
幸恵=Yukie
ゆっきー=Yuukii
峰 鈴音=Takashi Suzune
峰=Takashi
鈴音=Suzune
ベル=Bell
春日 陽花=Kasuga Haruka
春日=Kasuga
陽花=Haruka
はるかさん=Haruka-san
寺西 菫=Teranishi Sumire
寺西=Teranishi
菫=Sumire
すみ姉ぇ=Sumi-nee
山本 舞香=Yamamoto Maiko
山本=Yamamoto
舞香=Maiko
マイ=Mai
相原 麗奈=Aihara Rena
相原=Aihara
麗奈=Rena
レナ=Rena
熊倉 裕子=Kumakura Yuko
熊倉=Kumakura
裕子=Yuko
くま子=Kumako
船橋 由菜=Funabashi Yuna
船橋=Funabashi
由菜=Yuna
ユナ=Yuna
尾上 有紗=Onoe Arisa
尾上=Onoe
有紗=Arisa
アリサ=Arisa
臼井 義美=Usui Yoshimi
臼井=Usui
義美=Yoshimi
よっしー=Yosshii
野口 葉月=Noguchi Hazuki
野口=Noguchi
葉月=Hazuki
のぐっち=Nogucchi
飯田 佐奈=Iida Sana
飯田=Iida
佐奈=Sana
さなっぺ=Sanappe
高津 珠美=Takatsu Tamami
高津=Takatsu
珠美=Tamami
タマ=Tama
神崎 杏理=Kanzaki Anri
神崎=Kanzaki
杏理=Anri
アン=An
渡辺 汐里=Watanabe Shiori
渡辺=Watanabe
汐里=Shiori
しおりん=Shiorin
椎名 紅葉=Shiina Iroha
椎名=Shiina
紅葉=Iroha
しーな=Shiina
寺内 恵美=Terauchi Chiemi
寺内=Terauchi
恵美=Chiemi
ちえみ=Chiemi
日高 恵理子=Hidaka Eriko
日高=Hidaka
恵理子=Eriko
えーりん=Eirin
新垣 凛花=Shingaki Rinka
新垣=Shingaki
凛花=Rinka
りんか=Rinka
坪田 音々=Tsubota Nene
坪田=Tsubota
音々=Nene
ねねじゃ=Nene-jya
高瀬 一花=Takase Ichika
高瀬=Takase
一花=Ichika
いっちー=Icchii
卯月 かなめ=Uzuki Kaname
卯月=Uzuki
かなめ=Kaname
来栖 捺月=Kuzumi Natsuki
来栖=Kuzumi
捺月=Natsuki
なつき=Natsuki
花園 詩織=Hanazono Shiori
花園=Hanazono
詩織=Shiori
百瀬 妃奈乃=Momose Hinano
百瀬=Momose
妃奈乃=Hinano
ひなの=Hinano
滝川 かれん=Takagawa Karen
滝川=Takagawa
かれん=Karen
河野 珠子=Kawano Tamako
河野=Kawano 
珠子=Tamako
たまちゃん=Tama-chan
白峰 一乃=Shiramine Kazuno
白峰=Shiramine
一乃=Kazuno
かずのん=Kazunon
堀北 一瑠=Horitaka Itsuru
堀北=Horitaka
一瑠=Itsuru
いちる=Ichiru
伊丹 里沙=Itami Risa
伊丹=Itami
里沙=Risa
リサ=Risa
玉城 優=Tamaki Yuu
玉城=Tamaki
優=Yuu
ゆう=Yuu
神渡 クリスタ=Kamiwatari Krista
クリスタ=Krista
神渡=Kamiwatari
クリス=Kris
笠原 望夢=Kasahara Nozomu
笠原=Kasahara 
望夢=Nozomu
のぞみ=Nozomi
結城 萌=Yuuki Moe
結城=Yuuki
萌=Moe
もえ=Moe
北野 亜弥=Kitano Aya
北野=Kitano
亜弥=Aya
あや=Aya
