#set exe KoikatsuSunshine
#set level -1,1
終了確認=Exit Confirmation
ゲームを終了しますか？=Quit The Game?
はい=OK
いいえ=No
やめる=Cancel
タイトルへの切替確認=Confirm Return to Main Menu
タイトルへ戻りますか？=Back to the Main Menu?
一日の行動終了の確認=Confirm the end of the day's activities
部屋に帰りますか？=Return to your room?
「疲れたし今日は寝るか…」=I'm tired, I think I'll go to bed today...
「コイカツ」のデータを「コイカツサンシャイン」のデータに変換します。=Converting "Koikatsu" cards to "Koikatsu Sunshine" cards.
※ ファイル数が多いと時間がかかる可能性があります。=※ It may take some time if the number of files is large.
※ インストールフォルダ/UserData/chara/ に入っていた以前のデータは/UserData/chara/old/ に移動します。=※ The previous data in the folder /UserData/chara/ will be moved to /UserData/chara/old/.
何かキーを押して下さい=Press any key.
ロードする=Load
※ロードするデータを選択▼=※Select the file to load▼
ロード確認=Load Confirmation
以下のデータをロードします。=Load the following file:
※セーブされていないデータは破棄されます※=※ Data not saved will be discarded *
削除確認=Delete Confirmation
以下のデータを削除しますか？=Do you want to delete the following file?
※削除したデータは復帰しません※=※ Deleted files cannot be restored. ※
削除する=Delete
セーブする=Save
※セーブするデータを選択▼=※Select the file to save▼
セーブ確認=Save Confirmateion
データをセーブします。=Save file.
▼※以下のデータに上書きしますか※▼=▼ Do you want to overwrite the following file? ▼
●アルバム●=● Album ●
ページ=Page
撮影モード=1st Person
三人称モード=3rd Person
キャラ一覧\n=Character List\n
日付=Date
目的=Purpose
性格=Personality
バカンス=Vacation
知的好奇心=Curiosity
アウトドア=Activities
ランダム=Random
キャンセル=Cancel
私服=Casual Clothes
水着=Swimsuit
寝間着=Pajamas
風呂場=Bathing
お風呂=Bath
ポイント移動確認=Confirm new location
選択した場所に移動しますか？=Move to the selected place?
滞在先の変更確認=Confirm your change of accommodation
コイカツポイントを50pt消費して滞在先を変更しますか？=Do you want to spend 50 pts of your Koikatsu points to change the place you are staying?
オトセーブについて=About Autosaving
このゲムはオトセーブに対応しています=This game uses an autosave feature.
オトセーブ專用スロットが用意されており、初期設定では 1日の始まりに自動でセーブされます=Your game will be automatically saved at the beginning of the day.
<color%3D#ffa801ff>※「コンフィグ」にてオトセーブの設定変更を行えます</color>=<color%3D#ffa801ff>※You can change the autosave settings in the “Config” menu.</color>
オートセーブについて=About Autosaving
このゲームはオートセーブに対応しています。\n<size%3D24>\nオートセーブ専用スロットが用意されており、\n初期設定では1日の始まりに自動でセーブされます。\n</size>=This game uses an autosave feature.\n<size%3D22>\nThere is a dedicated slot for autosaving. By default, the game will be automatically saved at the beginning of the day.\n</size>
※「コンフィグ」にてオートセーブの設定変更を行えます。=※You can change the autosave settings in the “Config” menu.
お祈り=Prayer
本日はもう参拝しました。=I have already prayed today.
覗きシーン再確認=Peeping scene again
今の光景を思い出す=View the current scene again?
女の子と仲良くなれたら連れてこよう。=I'll bring the girls if I can get along with them.
今は通れないみたいだ。\nまた夜に来てみよう…=It looks like I can't pass now.\nI'll come back at night...
特殊=Special
あ=Ah
い=I
う=U
え=E
お=O
か=Ka
き=Ki
く=Ku
け=Ke
こ=Ko
さ=Sa
し=Shi
す=Su
せ=Se
そ=So
た=Ta
ち=Chi
つ=Tsu
て=Te
と=To
な=Na
の=No
は=Ha
ひ=Hi
ふ=Fu
ほ=Ho
ま=Ma
み=Mi
む=Mu
め=Me
も=Mo
や=Ya
ゆ=Yu
よ=Yo
ら=Ra
り=Ri
る=Ru
れ=Re
わ=Wa
確認=Confirmation
メモを記入できます=You can write notes
周りから視線を感じる…=I can feel someone's stare...
に入りますか？=Do you want to join?
シーン確認=Scene Confirmation
Hシーン確認=H Scene Confirmation
しよう=Let's do it
このままエッチに入りますか？=Want to go with the flow and have sex?
僕も混ぜて=Let me join in
