#set exe KoikatsuSunshine
#set level 8,9
女=Woman
男=Man
1人目=1st Girl
2人目=2nd Girl
服=Clothes
アクセサリー=Accessories
服装切り替え=Clothing Set
衣装切り替え=Clothing Set
コーディネート=Clothing Type
風呂=Bathing
お泊り=Pajamas
トップス=Top
ボトムス=Bottom
ブラ=Bra
ショーツ=Underwear
パンスト=Pantyhose
靴下=Socks
靴=Shoes
全着=Wear All
半脱=Half All
全脱=Remove All
全て付ける=Show All
全てはずす=Remove All
メインを付ける=Show Main
メインをはずす=Remove Main
サブを付ける=Show Sub
サブをはずす=Remove Sub
服の読み込み=Load Clothes
読込み=Load
表示選択=Choose Location
椅子=Chair
長椅子=Bench
背もたれ無し長椅子=Backless Bench
背もたれ無し椅子=Backless Chair
机=Desk
壁=Wall
プール内立ち=Inside Pool
プール=Pool
バナナボート=Banana Boat
寝=Floor
3P座り=3P Sitting
3P床=3P Floor
テニスネット=Tennis Net
フェンス=Fence
卓球台=Ping-Pong Table
軸の表示=Display Axis
移動軸のリセット=Reset Axis
回転軸のリセット=Reset Rotation
軸の選択\n=Axis Type\n
軸の速さ=Axis Speed
軸の大きさ=Axis Size
縦=Vert.
横=Horiz.
強さ=Power
入れるよ=Can we do it?
アナル入れるよ=Can we do anal?
イレル=Just do it
アナルイレル=Just do anal
入れて欲しい=You put it in.
ヌク=Pull out
ヌイテ=Pull out
中に出すよ=Cumming in you
外に出すよ=Cumming on you
またお願い=Do it again.
ユックリ=Go faster...
ハヤク=Go slower...
飲んでね=Swallow it.
吐いてね=Spit it out.
イキそう=About to cum
挿入で絶頂したい=I want to cum with you inside me.
あいうえおかきくけこさ=あいうえおかきくけこさ
