#set exe KoikatsuSunshine
#set level -1
滞在状況=Guest Status
プレイヤー=Player
※「 空室」にカーソルを合わせ、女の子を滞在させよう。=※ Hover your cursor over an empty room to choose where\nthe girl will stay. Double click to remove her.
情報表示=Show Info
この施設=This Location
ランダムに滞在=Random Guests
滞在を全解除=Clear All
全施設=All Locations
登録可能人数を最大にする=Increase the number of rooms
滞在者の表示人数=Number of people to be shown
決定=Done
選択中=Select
誕生日/=Birthday
月= M
日= D
血液型/=Blood Type
型= 
滞在目的=Purpose for Stay
性格:=Pers:
愛称:=Nick:
滞在者登録=Register Guest
ランダムに登録=Random Registration
サンプルキャラ=Stock character
キャラフォルダ=Character Folder
ネットワーク=Network
新規作成=Create New
容姿変更=Appearance
滞在先の変更=Change Location
滞在を解除=Check-out
移動中=Moving
ここに移動=Go Here
入れ替える=Replace
プレイヤーの愛称=Player's Nickname
変更=Change
全解除=Clear All
全選択=Select All
個性=Traits
はらぺこ=Hungry
チョロイ=Simple
読書好き=Likes Reading
音楽好き=Likes Music
奥手=Immature
フレンドリー=Friendly
綺麗好き=Likes Cleanliness
神出鬼没=Suddenly Appears
一人好き=Likes Being Alone
アクティブ=Active
真面目=Diligent
情報通=Well-Informed
恋愛好き=Romantic
おしゃべり=Chatty
仲間意識=Fellowship
のんびり=Relaxed
頻尿=Pees Often
女の子好き=Likes Girls
ビッチ=Slutty
むっつり=Gloomy
寂しがり屋=Lonely
個別に呼ばれる愛称を選択できます▼=You can choose a nickname to be called personally ▼
呼ばれる愛称を選択してください▼=Choose a nickname to be called ▼
この女の子に呼ばれる愛称を設定▼=Set a nickname to be called by this girl ▼
プレイヤーの名前▼=Player name ▼
共通で呼ばれる愛称=Default Nickname
個別で呼ばれる愛称=Personal Nickname
共通の愛称に戻す=Default Nickname
プレイヤー情報=Player Info
呼ばれる愛称=Called by the Nickname
案内人情報=Guide Info
観光案内人=Tourist Guide
アルバイト=Part-time Job
関係性=Relationship
ワンポイントアドバイス=One Point Advice
登録キャラの解除確認=Confirm the character removal
解除しますか？=Do you want to remove this girl?
登録キャラの一括解除確認=Confirm bulk character removal
施設内のキャラを解除しますか？=Do you want to remove all characters from this location?
全キャラを解除しますか？=Do you want to remove all characters?
呼び出し先の確認=Confirm call destination 
<color%3Dorange>『選択した空席』</color>に\n以下からランダムで\nキャラを滞在させます。=<color%3Dorange>Selected Room</color> will be occupied by a random character.
