#set exe KoikatsuSunshine
#set level 11
未選択=Not Selected
名前=Name
YES=Yes
NO=No
行為選択=Action
通常=General
オナニー=Masturb.
レズ=Lesbian
複数=3P
女キャラ選択=Select Girl
女の子選択=Select Girl
性格=Personality
性感帯=Erogenous Zone
キスを拒否しない？=Kisses Okay?
激しい愛撫を拒否しない？=Groping Okay?
電マを拒否しない？=Toys Okay?
アナルを拒否しない？=Anal Okay?
ゴム付けなくてもOK？=Condomless Okay?
唇=Lips
胸=Chest
股間=Crotch
アナル=Anus
尻=Butt
乳首=Nipples
H段階=H-Level
初めて=1st Time
不慣れ=Inexp.
慣れ=Exp.
淫乱=Horny
状態=Safety
安全日=Safe Day
危険日=Risky Day
マップセレクト=Select Map
ここでHする=H Here
男キャラ選択=Select Boy
マップ選択=Select Map
時間帯=Time Of Day
朝=Dawn
昼=Noon
夕方=Dusk
夜=Night
発見=Discovery
されてない=Not Found
されてる=Found
相手キャラ選択=Select Partner
女の子1人目=Girl #1
女の子2人目=Girl #2
決定=Accept
