クレア四角=Claire Square
クレア輪=Claire Wheel
クレア左=Claire L
クレア右=Claire R
クレア丸=Claire Circle
クレア尻=Claire Butt
ヴァルキリーショルダー右用=Valkyrie shoulder R
ヴァルキリーショルダー左用=Valkyrie shoulder L
サキュバスショルダー右用=Succubus shoulder R
サキュバスショルダー左用=Succubus shoulder L
スタッズレザーアーム左用=Studded leather arm L
スタッズレザーアーム右用=Studded leather arm R
エキゾチックリング左用=Exotic Ring L
エキゾチックリング右用=Exotic Ring R
ガンツ丸1個=Gantz Round 1pc
ガンツ丸靴用４個=Ganz Round for Shoes 4 pcs
ガンツ丸横２個=Ganz Round Horizontal 2 pcs
ガンツ丸縦２個=2 vertical Ganz rounds
ガンツ丸腕用４個=4 Gants for arms
ガンツ丸首用４個=4 pcs for neck
ガンツ丸金属=Gantz Maru Metal
光る円柱=Glowing Cylinder
Qテクターパーツ=Q-Tector Parts
光る立方体=Glowing Cube
光る球体=Glowing Sphere
キラメイチェンジャー=Kira Mei Changer
マイン鎧手首=Mine Armor Wrist
マイン鎧手甲左=Mine Armor Hand Armor L
マイン鎧手甲右=Mine Armor Hand Armor R
マイン鎧肘左=Mine Armor Elbow L
マイン鎧肘右=Mine Armor Elbow R
マイン鎧膝=Mine Armor Knee
マイン髪留め=Mine Hair Clip
盾の勇者の盾=Shield Hero Shield
オレンジバルーン=Orange Balloon
ミロ腕=Milo Arm
ミロ手=Milo Hand
ミロ肩=Milo Shoulder
魔術刻印=Magical Mark
衛士強化装備肩=Pilot Fortified Suit (shoulder)
ＢＢ=BB
AIダクトテープ芯=AI duct tape core
騎士のリボン[アリス]=Knight's ribbon [Alice][SAO
整合騎士のリボン[アリス][SAO]=Alignment Knight's Ribbon [Alice][SAO]
腕輪：創世神ステイシア[SAO]=Arm band: Stacia, God of Creation [SAO].
レーナ[86-EIGHTY SIX-]=Raina [86-EIGHTY SIX-]
ドクロ=Skull
