全身タイツ=Full-Body Tights
バニースーツ=Bunny Suit
ハロウィントップス=Halloween Top
サキュバスの翼左用=Succubus' Wing for L
サキュバスの翼右用=Succubus' Wing for R
シンプル乳首リング=Simple Nipple Ring
乳首リング改=Nipple Ring Kai
乳首リングジュエル改=Nipple Ring Jewel Kai
サーキュラーバーベルピアス=Circular Barbell Earrings
サーキュラーバーベルジュエルピアス=Circular Barbell Jewel Earrings
バナナバーベルピアス=Banana Barbell Earrings
バナナバーベルジュエルピアス=Banana Barbell Jewel Earrings
ストレートバーベル短ピアス=Straight Barbell Short Earrings
ストレートジュエルバーベル短ピアス=Straight Jeweled Barbell Short Earrings
ストレートバーベル長ピアス=Straight Barbell Long Earrings
ストレートジュエルバーベル長ピアス=Straight Jeweled Barbell Long Earrings
アローバーベルピアス=Arrow Barbell Earrings
アローバーベルジュエルピアス1色=Arrow Barbell Jewel Earrings 1 color
アローバーベルジュエルピアス2色=Arrow Barbell Jewel Earrings 2 colors
アローバーベルジュエルピアス3色=Arrow Barbell Jewel Earrings 3 colors
ビーズシールド=Bead Shield
ビーズシールドピアス=Bead Shield Earrings
ビーズシールドジュエルピアス=Bead Shield Jewel Earrings
1色ジュエルシールド=1 color jewel shield
1色ジュエルシールドピアス=1 color jewel shield earrings
1色ジュエルシールドジュエルピアス=1 color jewel shield jewel earrings
2色ジュエルシールド=2 Color Jewel Shield
2色ジュエルシールドピアス=2 Color Jewel Shield Earrings
2色ジュエルシールドジュエルピアス=2 color jewel shield jewel earrings
悪魔の翼左用（改）=Devil's Wing L (Revised)
悪魔の翼右用（改）=Devil's Wing R (Revised)
AI翼=AI Wings
レオタード=Leotard
ハイレグレオタード=High-Leg Leotard
スクール水着_small=School swimsuit_small
クッパのこうら=Bowser's Shell
アーマープレート_k=Armor Plate_k
セーラー重ね着カーディガン１=Sailor Layered Cardigan 1
セーラー重ね着カーディガン２=Sailor Overlapping Cardigan 2
光翼_エデンVB=Hikari Tsubasa_Eden VB
光翼_エデンVB_アニメ無=Light Wings_Eden VB_without animation
蝶翅_嵐燐結騎=butterfly wing_storm phosphorus knight
蝶翅_嵐燐結騎_エフェ無=butterfly wing_storm_rink_without_effect
蝶翅_嵐燐結騎_アニメ無=wing_storm_rin_without_animation
背負いカバン（取手なし）=Backpack (without handle)
デイパック=daypack
スクール水着=School Swimsuit
競泳水着=Competition Swimsuit
クモの巣=Spiderweb
勲章=medals
メダル=medal
プレゼント袋=Gift Bag
スノークリスタル=Snow Crystal
悪魔の翼左用=Demon Wing L
悪魔の翼右用=Demon Wing R
