聖女の首飾り=Saint's necklace
盗賊のマフラー=Thieves' scarf
スカルブローチ=Skull brooch
エキゾチックネックレス=Exotic necklace
ロングリボン=Long ribbon
シノンマフラー=Sinon scarf
シノン腰のヤツ=Sinon waist guy
衛士強化装備首=Pilot Fortified Suit (neck)
鈴付きチョーカー =Bell Choker
騎士のマント[アリス]=Knight's cloak [Alice].
ネックレス[アリス]=Necklace [Alice].
整合騎士のマント[アリス][SAO]=Matching knight's cloak [Alice][SAO].
ネックレス[アリス][SAO]=Necklace [Alice][SAO].
太陽神ソルス[SAO]=Solus, God of the Sun[SAO].
レーナ[86-EIGHTY SIX-]=Raina [86-EIGHTY SIX-]
ルーズネックリボン１=Loose neck ribbon 1
ルーズネックリボン２=Loose neck ribbon 2
ルーズネクタイ=Loose necktie
えり巻き=necktie wrap
くび巻き=Neck Wrap
マフラー無地（WBAccs）=Scarf plain (WBAccs)
マフラー無地=Scarf Plain
クリスマスベル=Christmas Bells
エトワールブローチ=Star Choker
付けフード=Attached hood
付けマント=attached cape
ドッグタグ=Dog tag
十字架=Crucifix
チョーカー=Choker
タイ=Tie
ルーズタイ=Loose Ties
リボンタイ=Ribbon Tie
