聖女の腰飾り=Saint's Waistcoat
盗賊のベルト=Bandit's Belt
盗賊のポーチ=Thief's Pouch
バゼラードの鞘=Bazelard's Sheath
サキュバス尻尾=Succubus Tail
サキュバスのランタン=Succubus Lantern
ネクロマンサーの腰飾り=Necromancer's Waistcoat
魔力の砂時計=Hourglass of Magic
ネクロマンサーベルト=Necromancer Belt
魔術師のポーチ=Sorcerer's Pouch
闇の守り=Charm of Darkness
贵族风衣腰饰=Necromancer's waistcoat
小悪魔尻尾(リボンなし)=Little devil tail (without ribbon)
ジェム1=Gem 1
ジェム2=Gem 2
ジェム3=Gem 3
ジェム4=Gem 4
ジェム5=Gem 5
メタルベルト=Metal belt
ポーチ=Pouch
猫尻尾=Cat Tail
エプロン=Apron
金木犀の剣の鞘[アリス]=Scabbard of the Sword of the Golden Rhinoceros [Alice]
金木犀の剣(納刀)[アリス]=Sword of the Golden Rhinoceros [Alice][SAO]
金木犀の剣の鞘[アリス][SAO]=Scabbard of the Sword of the Golden Rhinoceros [Alice][SAO]
金木犀の剣(納刀)[アリス][SAO]=Sword of the Golden Rhinoceros [Alice][SAO].
ラディアントライトの鞘[SAO]=Radiant Light Scabbard [SAO][Alice
ラディアントライト(納刀)[SAO]=Radiant Light (sword)[SAO][SAO
ヴァーデュラス・アニマの鞘[SAO]=Verdurus Anima Scabbard [SAO]
ヴァーデュラス・アニマ(納刀)[SAO]=Verdurus Anima (sword)[SAO][SAO
シノン(ケットシー)[SAO]=Sinon(Ketsee)[SAO][SAO
レーナ[86-EIGHTY SIX-]=Raina [86-EIGHTY SIX-]
オーバースカート・プリーツＡ=Overskirt Pleats A
オーバースカート・プリーツロングＡ=Overskirt Pleated Long A
クリーム1=Cream 1
クリーム2=Cream 2
イチゴ=Strawberries
尻尾_エデンVB=Tail_Eden VB
尻尾_エデンVB_アニメ無=Tail_Eden VB_without animation
コートベルト=Coat Belt
トナカイ=Reindeer
ソリ=Sled
スフィア=Sphere
キューブ=Cube
ピラミッド=Pyramid
コーン=cone
シリンダー=Cylinder
クリスタル=Crystals
リング=Ring
星１=Star 1
星２=Star 2
星３=Star 3
星４=Star 4
ハート１=Heart 1
ハート２=Heart 2
爪=Claw
筒１=Tube 1
筒２=Tube2
パイプ１=Pipe 1
パイプ２=Pipe 2
台形１=Trapezoid 1
台形２=Trapezoid 2
矢印１=Arrow 1
矢印２=Arrow 2
矢印３=Arrow 3
穴あきキューブ=Cube with holes
直角１=Right angle 1
直角２=Right angle 2
直角３=Right angle 3
三日月１=Crescent1
三日月２=Crescent 2
三日月３=Crescent 3
十字=Cross
V字=V-shape
穴あき楕円=Oval with hole
先尖り棒=Pointed bar
三角=Triangle
穴あき三角=Perforated triangle
弧１=Arc 1
弧２=Arc 2
弧３=Arc 3
四分円=Quarter circle
半円=Semicircle
五角形=Pentagon
六角形=Hexagon
穴あき六角形=Hexagon with hole
八角形=Octagon
頭=Head
平面=Plane
輪=Ring
カプセル=Capsule
正台形=regular trapezoid
山型多角形1=Mountain polygon 1
山型多角形2=Mountain polygon 2
長六角形=Long hexagon
長五角形=Long pentagon
歪み三角柱=Distorted triangular prism
マウス型右=Mouse-type R
マウス型左=Mouse-type L
五角横台形=Pentagonal horizontal trapezoid
円形横台形=Round horizontal trapezoid
三角横台形=Triangular trapezoid
ドロップ立体=Drop solid
ドロップ平面=Drop plane
ひょうたん立体=Gourd
ひょうたん平面=Gourd plane
角リング=Square ring
立体半円=Three-dimensional semicircle
立体四半円=3D semicircle
角型=Square shape
直角形=Rectangle
斜ひし形=Oblique rhombus
歪み台形=Distortion trapezoid
欠け四角=Missing square
二対多角形=Two-pair polygon
ヒレ型=Fin-shaped
歪み多角形=Distortion polygon
角なし斜ひし形=Diagonal rhombus without corners
角なし歪み台形=Cornerless distorted trapezoid
角なし四角錐=Quadrilateral pyramid without corners
角なし三角=Triangle without corners
角なし四角=Quadrilaterals without corners
筒四分=Cylinder quadrant
ディストーション 球=Distortion Sphere
ディストーション 平面=Distortion Plane
サイドドレープ [マスク変更]=side drape [mask change].
サイドドレープ [リボンなし]=side drape [without ribbon]
サイドドレープ[白透過]=Side drape [white transparent].
