ドリルツインテール=Drill twin tails
乃愛=Noa
[dak]リボンなしロングサイド広い(左テール無し)=[dak] long side wide without ribbon (no left tail)
[dak]ウエーブロング広い=[dak] wavy long wide
[dak]ツインロングおさげ(改)=[dak] twin long pigtails (modified)
[dak]中分ボブ(後)=[dak]Medium-length bob (back)
三つ編み[アリス][SAO]=Braids [Alice][SAO].
地神テラリア[SAO]=Earth God Terraria [SAO].
サイドテール（左)（テールなし）=Side Tail (L) (No Tail)
サイドテール(右)（テールなし）=Side Tail (R) (No Tail)
ツインおさげ（テールなし）=Twin pigtails (without tails)
ポニーテ-ル（テールなし）=Ponytail (no tail)
サイドアップ(左)（テールなし）=Side Up (L) (No Tail)
サイドアップ(右)（テールなし）=Side up (R) (no tail)
細ツインテール（テールなし）=Thin Twin Tail (No Tail)
ツーサイドアップ（テールなし）=Two Side Up (No Tail)
ショートショート=Short Short
紗霧=Sagiri
ふんわりロング_オーロラAL=Fluffy Long_Aurora AL
クロスカールロング_エデンVB=Crossed Curl Long_Eden VB
ツーサイドアップ_嵐燐結騎=Two Side Up_Arashi Rin Yuki
セミロング=Semi-Long
ショートカット=Short cut
ツインテール=Twintails
ロング=Long
お団子=Bun
サイドテール=Side Tail
つんつんベリーショート=Pointy Belly Short
リーゼント=Ducktail
流しベリーショート=Flowing Belly Short
ボウズ=Bowed
くせっ毛ベリーショート=Curly Belly Short
wen立华奏=wen liyuan
wen妖精=wen Fairy
wen夜夜=WEN Night Night
ロングヘア アウトライン=Long Hair Outline
ボブヘア アウトライン=bob hair outline
ポニーテール 中結び=Ponytail Medium Knot
ショート アウトライン=short hair outline
外はねロング アウトライン=Long Outlines
ベリーロング 短=Belly Long Short
ストレートミディアム アウトライン=Straight Medium Out Line
セミロング アウトライン=Semi-Long Outline
外はねショート 長=Curly Short Length
ぱっつんロング 短=Straight-cut Long Short
カールボブ アウトライン=Curly Bob Outline
ベリーショート 長=Belly Short Long
カールポニー アウトライン=Curly Pony Outline
ゆるふわボブ アウトライン=Loose Bob Outline
ぱっつんボブ アウトライン=Floppy Bob Outline
なし=None
ぼーず=Bozu
ぼーず2=BOBZ2
穴埋め=Hole Filling
ぼーず＋穴埋め=Bozu + Hole Filling
ツイン テールなし1=Twin Tail-less 1
ツイン テールなし2=Twin without tail 2
ポニー テールなし=Pony without tail
サイド テールなし1=Side Tail-less 1
サイド テールなし2=Side without tail2
サイドアップ テールなし1=Side up without tail1
サイドアップ テールなし2=Side Up No Tail2
ツーサイドアップ テールなし=Two Side Up No Tail
ツーサイドアップS テールなし=Two Side Up S No Tail
