クレアレオタード=Claire Leotard
あんせレインコート=Safety Raincoat
聖女のビスチェ=Saint Bustier
サキュバスビスチェ=Succubus Bustier
亀甲縛り改1=Tortoise Shell Binding Kai 1
亀甲縛り改2=Tortoise Shell Binding Kai 2
ナミブラ=Nami Bra
搭配HS男衬衣用T恤=T-shirt for HS man's polo shirt
贵族腰带=Women's waistband
贵族风衣=Clothes for noble families
偶像服肩章=Shoulder patch
王子服肩章=Shoulder patch for prince
军服肩章=Shoulder patch for military uniform
肩章=Shoulder patch
军服腰带=Military uniform waistband
偶像肩章改=Idol epaulettes corrected
王子服束腰=Prince's uniform
黎恩(下摆腰带扣)=Reign (Lower & Fore Waistband)
全身金属タイツ=Full-length metal tights
三等官アンダー=Third Class Officer Under
黒波プラグスーツ=Black Wave Plug Suit
ブルーウィンド上=Blue Wind Upper
チライインナー=Chirai Inner
フミナ=Fumina
フミナ2=Fumina 2
半脱ぎガンツスーツ=Half Undressed Gantz Suit
ガンツスーツインナー=Gantz Suit Inner
ガンツスーツインナー2=Gantz Suit Inner 2
HotLimit衣装=HotLimit Costumes
Qテクター=Q-Tector
Qテクター(ツヤ)=Q-techter (Tsuya)
真希波用ヴィレプラグスーツ=Vire Plug Suit for Makinami
式波用ヴィレプラグスーツ=Vire Plug Suit for Shikinami
マキノレオタード=Makino Leotard
マシュ=Marsh
マシュインナー=Marsh Innerwear
ミライアカリ=Mariah Carey
ミロスーツ=Milo Suit
クロップドチューブトップ=Cropped Tube Top
レーシングミク2019=Racing Miku 2019
テカテカ真希波プラグスーツ=Tekateka Makinami Plug Suit
テカテカ式波プラグスーツ=Tekateka Shikinami Plug Suit
テカテカ黒波プラグスーツ=Techa Techa Black Wave Plug Suit
シノンインナー=Sinon Innerwear
ヨーソロー水着=Yossorow Swimsuit
フリル水着（フリルなし）=Frill Swimsuit (No Frill)
スクール水着_small =School swimsuit_small
スクール水着_small2 =School swimsuit_small2
Maハイローブラ=Ma high-low bra
聖女堕とし=Saint Corruption
オープンビキニ=Open bikini
オープンビスチェ =Open bustier
オープンフリルビキニ=Open Frilled Bikini
Millefi水着=Millefi Swimsuit
穴あきスク水=School Swimwear with Holes
ハート穴スク水=Heart Hole School Swimsuit
破れスク水=Torn School Swimsuit
チューブトップ=Tube Top
ツヤありチューブトップ=Shiny tube tops
ミニチューブトップ=Mini Tube Tops
レーナ[86-EIGHTY SIX-]=Raina [86-EIGHTY SIX-]
透過全身タイツ VerA=Transparent Full Length Tights Ver.
透過全身タイツ VerB=Transparent Full-Body Tights Ver.
疑似ヌルテカボディ=Pseudo-slippery body
さらしショート無地=Sarashi Short Plain
亀甲縛り=Tortoise Shell Binding
フルカップブラ=Full Cup Bra
フルカップブラ 柄付き=Full Cup Bra with Pattern
4/5カップブラ=4/5 Cup Bra
4/5カップブラ 柄付き=4/5-Cup Bra with Pattern
3/4カップブラ=3/4 Cup Bra
3/4カップブラ 柄付き=3/4 Cup Bra with Pattern
1/2カップブラ=1/2 Cup Bra
1/2カップブラ 柄付き=1/2 Cup Bra Patterned
紐付きチューブトップブラ=Tube Top Bra with Straps
紐付きチューブトップブラ 柄付き=Tube Top Bra with Straps Patterned
シェルフカップブラ=Shelf Cup Bra
シェルフカップブラ 柄付き=Shelf Cup Bra with Pattern
オープンブラ=Open Bra
オープンブラ エナメル風味=Open bra with enamel
フルカップブラ1 ver1=Full Cup Bra 1 ver1
フルカップブラ2 ver1=Full Cup Bra 2 ver1
4/5カップブラ1 ver1=4/5 Cup Bra1 ver1
4/5カップブラ2 ver1=4/5 Cup Bra 2 ver1
3/4カップブラ1 ver1=3/4 Cup Bra 1 ver1
3/4カップブラ2 ver1=3/4 Cup Bra 2 ver1
1/2カップブラ1 ver1=1/2 Cup Bra 1 ver1
1/2カップブラ2 ver1=1/2 Cup Bra 2 ver1
紐付きチューブトップブラ1 ver1=Tube Top Bra with Strings 1 ver1
紐付きチューブトップブラ2 ver1=Tube top bra with strings 2 ver1
シェルフカップブラ ver1=Shelf Cup Bra ver1
オープンブラ ver1=Open Bra ver1
ひもぴーんビキニ=Flouncy Bikini
ひもぴーんビキニ　ツヤ=Flouncy bikini Glossy
ひもぴーんマイクロビキニ=Floppy micro bikini
ひもぴーんバンドゥビキニ=Hymopy bandeau bikini
ひもぴーん△ビキニ=Hymopy △ bikini
ひもぴーんマイクロ△ビキニ=Hymopy micro bikini
ひもぴーんビキニ カラバリ=Pimpin bikini Color variation
ひもぴーんビキニ　ツヤ　カラバリ=Pimpin bikini Glossy Calabash
ひもぴーんマイクロビキニ　カラバリ=HIMOPYN micro bikini Calabash
ひもぴーん△ビキニ　カラバリ=HIMOPYN bikini -color variation
ひもぴーんマイクロ△ビキニ　カラバリ=HIMOPYN micro bikini -color variation
メタルひもぴーんビキニ=Metal string bikini
メタルひもぴーんマイクロビキニ=Metal string micro bikini
メタルひもぴーんバンドゥビキニ=Metal string bandeau bikini
メタルひもぴーん△ビキニ=Metal string bikini
メタルひもぴーんマイクロ△ビキニ=Metal string micro bikini
新スク=New School
競スク=Competition swimwear
ワンピース水着=One-piece swimwear
チューブトップ紐クロス=Tube top string cross
チューブトップ紐センター=Tube top string center
極小マイクロブラ=Ultra-small micro bra
フロントホック 横ぽろり=Front Hook Side Purl
フロントホック 前ぽろり=Front Hook Front Porous
ひもぴーん2nd三角ビキニ=Himopy 2nd triangle bikini
ひもぴーん2ndクロス三角ビキニ=Himopy 2nd cross triangle bikini
三角ブラ(ツヤ)=Triangle bra (glossy)
ストラップレスブラ(ツヤ)=Strapless bra, lustrous
レオタード (袖なし)=Leotard (Sleeveless)
ハイレグレオタード (袖なし)=High-Leg Leotard (Sleeveless)
全身タイツ(ショーツ可)=Full-length tights (shorts allowed)
ビキニ水着 (3色変更可)=Bikinis (3 colors available)
ハートカット競泳水着=Heart cut swimsuit
ハートカット競泳水着 ツヤ有り=Heart cut swimsuit with luster
ハートカットビキニ水着=Heart cut bikini swimsuit
ハートカットビキニ水着 ツヤ有り=Heart cut bikini swimsuit with luster
ハートカットレオタード=Heart Cut Leotard
ハートカットレオタード ツヤ有り=Heart cut leotard with luster
サンタ=Santa Claus
ハイレグバニーH_A（襟op）=High-Legged Bunny H_A (collar op)
ハイレグバニーH_B（襟op）=High-Legged Bunny H_B (Collar op)
ハイレグバニー（重ね着用/襟op）=High-Legged Bunny (Overlapping / Collar op)
ブラジル水着（張り極小）=Brazilian swimsuit (very small tension)
ブラジル水着（張り小）=Brazilian swimsuit (Tension small)
ブラジル水着（張り中）=Brazilian swimsuit (medium tension)
ブラジル水着（張り大）=Brazilian swimsuit (large)
xne水着Ａ=XNE Swimsuit A
xne水着Ａ（透け）=XNE Swimsuit A (transparent)
xneレース下着=XNE Lace Underwear
ひも水着=String swimsuit
ひも水着（透け）=Braided swimsuit (transparent)
ひも水着（巨乳）=String swimsuit (Big tits)
ひも水着（巨乳／透け）=String swimsuit (Big tits / Transparent)
ボディタイツ（筋肉質）=Body Tights (Muscular)
ボディタイツ透け（筋肉質）=Body tights transparent (muscular)
ボディタイツ（普通）=Body tights (normal)
ボディタイツ透け（普通）=Body Tights Transparent (Normal)
ボディタイツ（痩せ）=Body Tights (Skinny)
ボディタイツ透け（痩せ）=Transparent body tights (skinny)
眼帯ビキニ=Eye patch bikini
眼帯ビキニ（紐ピン）=Eye patch bikini (string pin)
四角ビキニ=Square bikini
四角ビキニ（紐ピン）=Square bikini (string pins)
チューブトップ水着=Tube top swimsuit
チューブトップ水着（胸張り）=Tube top swimsuit (breast padding)
チューブトップ水着H=Tube top swimsuit H
クロスネック=Cross neck
アンダーシャツ1=Undershirt 1
アンダーシャツ2 ロングレギンス=Undershirt 2 Long leggings
アンダーシャツ2 スパッツ=Undershirt 2 Spats
アンダーシャツ3 ツートン=Undershirt 3 Two-Tone
アンダーシャツ3 ツートン 袖短=Undershirt3 Two-Tone Short Sleeves
アンダーシャツ3 首まで=Undershirt 3 Up to Neck
アンダーシャツ3 首まで 袖短=Undershirt 3 Up to neck Short sleeves
アンダーシャツ3 ツートン rev11=Undershirt 3 two-tone rev11
アンダーシャツ3 ツートン 袖短 rev11=Undershirt 3 Two-Tone Short Sleeves rev11
アンダーシャツ3 首まで rev11=Undershirt 3 up to neck rev11
アンダーシャツ3 首まで 袖短 rev11=Undershirt 3 up to neck, short sleeves rev11
スクール水着 テカ=School swimsuit Teka
競泳水着 テカ=Swimsuit, teka
マイクロビキニ（上）=Micro bikini (top)
透けスクール水着=Transparent School Swimsuit
透け競泳水着=Transparent swimsuit
ハート=Heart
星=Star
クロス=Cross
ハート 小=Heart Small
絆創膏=Bandage
