あんせフレアスカート=Anse Flare Skirt
ハイウエストスカート(フリル付き)=High-Waist Skirt (with Ruffles)
ハイウエストスカート(サスペンダー付き)=High-Waist Skirt (with Suspenders)
ハイウエストスカート=High-Waist Skirt
二段フリルスカート=Two-tiered Frilled Skirt
ヴァルキリースカート=Valkyrie Skirt
盗賊のズボン=Thieves' Trousers
サキュバスの腰飾り=Succubus' Waistcoat
ネクロマンサーのズボン=Necromancer's Trousers
聖女のビスチェ_kumbhira_bot=Saint's bustier - kumbhira_bot
盗賊のズボン (Pantsu Allowed)=Thief's pants (Pantsu Allowed)
ブルマ1A=Bloomers 1A
ブルマ1B=Bloomers 1B
ブルマ2A=Bloomers 2A
ブルマ2B=Bloomers 2B
ブルマ3A=Bloomers 3A
ブルマ3B=Bloomers 3B
ローライズロングパンツLv1=Low-rise long pants Lv1
ローライズロングパンツLv2=Low-rise long pants Lv2
ローライズロングパンツLv3=Low-rise long pants Lv3
ローライズロングパンツLv4=Low-rise long pants Lv4
偶像长裤=Even long pants
挽裤脚长裤=Long pants
礼服长裤(靴用)=Long pants (for shoes)
宽松长裤靴版=Kukamatsu long pants shoe version
宽松长裤外版=Kuanmu long pants outer version
HS2贵族长裤=HS2 long pants
宽松礼服长裤=Long pants for formal wear
休闲长裤=Casual long pants
闪轨本校制服=Internal channels
闪轨军服=Channel cloth
黎恩服饰=Beach Beach Clothing
ミクスカート=Mini skirt
チライベルト=Chirai Belt
逗子総合=Zushi General
タイトスカートパンテラ=Tight Skirt Panthera
マキノスカート=Makino Skirt
マシュ鎧腰=Marsh Armored Waist
マシュ鎧腰テカ=Marsh Armor Waist Teka
マインスカート=Mine Skirt
ミライアカリ=Mariah Carey
乙倉パンツ=Otokura Pants
シノンチャップス=Chinon Chaps
前開きショートパンツ=Front-opening shorts
前開きホットパンツ=Front-opening hot pants
前開きスカートA=Front-opening skirt A
前開きスカートB=Front-open skirt B
ランニングショーツA=Running Shorts A
ランニングショーツB=Running Shorts B
スウェットパンツA=Sweatpants A
スキマホットパンツ=Skimmer Hot Pants
アイドルスカート=Idle Skirts
ボックススカートAへそ出し=Box skirt A Navel-baring
島風スカート=Shimakaze Skirt
セクシーランジェリー（下）=Sexy Lingerie (Bottom)
穴あきホットパンツ=Hot Pants with Holes
ハート穴ホットパンツ=Heart Hole Hot Pants
ミニミニタイトスカート=Mini Mini Tight Skirts
ミニミニタイト(ベルトなし)=Mini Mini Tight (without belt)
超ミニミニタイトスカート=Super Mini Mini Tight Skirts
超ミニミニタイト(ベルトなし)=Super Mini Mini Tight (Without Belt)
食い込みブルマ=Blooming Bloomers
食い込みブルマ2=Full Length Bloomers 2
プリーツスカート (アリス)=Pleated Skirt (Alice)
スカート[アリス][SAO]=Skirt [Alice][SAO]
創世神ステイシア[SAO]=God of Creation Stacia [SAO][SAO
地神テラリア[SAO]=Earth God Terraria [SAO].
太陽神ソルス[SAO]=Solus, God of the Sun[SAO].
レーナ[86-EIGHTY SIX-]=Raina [86-EIGHTY SIX-]
ニッカ(Low無)=Knickers (Low)
脚絆ニッカ(Low無)=Leggings Nikka (without Low)
クリーム=Cream
コンドームスカート=Condom Skirt
ローソンコラボスカート=Lawson Collaboration Skirt
パーティースカート=Party Skirt
パーティースカート-rose=Party Skirt-rose
ペチコート付きショートプリーツスカート1=Short Pleated Skirt with Petticoat 1
ペチコート付きショートプリーツスカート2=Short Pleated Skirt with Petticoat2
ペチコート付きショートボックススカート1=Short Box Skirt with Petticoat1
ペチコート付きショートボックススカート2=Short Box Skirt with Petticoat2
フリル付きショートプリーツスカート1=Short Pleated Skirt with Ruffles1
フリル付きショートプリーツスカート2=Short Pleated Skirt with Ruffles2
フリル付きショートボックススカート1=Short Box Skirt with Ruffles1
フリル付きショートボックススカート2=Short Box Skirt with Ruffles2
アシメスカート=Asymmetrical Skirt
アシメスカート 3色=Asymetrical Skirt 3 Colors
アシメスカート ロング 3色=Asymetrical Skirt Long 3 Colors
段フリルスカート=Tiered Ruffled Skirt
段フリルスカート_djeeta=Tiered Ruffle Skirt_djeeta
3段プリーツスカート ver2=3 Tier Pleated Skirt ver2
5段プリーツスカート ver2=5 tier pleated skirt ver2
7段プリーツスカート ver2=7 tier pleated skirt ver2
9段プリーツスカート ver2=9 tier pleated skirt ver2
ショートプリーツスカートA_collider=Short Pleated Skirt A_collider
ショートボックススカートA_collider=Short Box Skirt A_collider
ショートボックススカートB_collider=Short Box Skirt B_collider
ショートプリーツスカートB_collider=Short Pleated Skirt B_collider
ショートフレアスカートA_collider=Short Flared Skirt A_collider
ショートフレアスカートB_collider=Short Flared Skirt B_collider
ショートチアスカート_collider=Short Cheer Skirt_collider
ショートテニススカート_collider=Short Tennis Skirt_collider
NBYスカート=NBY Skirts
NBYパンツ=NBY Pants
ホットパンツ(破)=Hot Pants(Ripped)
ショートパンツ(破)=Short Shorts (Ripped)
ホットパンツ(大破)=Hot Pants (Large Tear)
ショートパンツ(大破)=Shorts (Wrecked)
ホットパンツ(濡)=Hot pants (wet)
ショートパンツ(濡)=Shorts (wet)
ショートパンツ(大濡)=Wet shorts
ジーンズ(ロールアップ)=Jeans (Roll-up)
RUデニム(濡)=RU Denim (Wet)
RUデニム(大濡)=RU Denim (Large Wet)
軍服=Military Uniform
王子服=Prince Uniform
スリム王子服=Slim Prince Uniform
サスペンダーズボン=Suspender Pants
wen立华奏=wen liyuan
wen妖精=wen Fairy
wen夜夜=WEN Night Night
汎用短パン=General Shorts
へそ出し短パン=Bellybutton Shorts
脇開き短パン=Side Opening Shorts
前開きズボン=Front Opening Pants
前開きダンスズボン=Front-open dance pants
前開きズボンベルト付き=Front-opening pants with belt
前開きダンスズボンベルト付き=Front-open dance pants with belt
エジプト風透け腰布=Egyptian style transparent waist cloth
エジプト風透け腰布（柄あり）=Egyptian transparent waistcloth (with pattern)
エジプト風透け腰布Ｈ=Egyptian style transparent waistcloth H
前あきパレオ=Pareo with open front
前あき腰布A=Pareo with front open
前あき腰布A（巻きのみ）=Egyptian transparent waistcloth
ローレグホットパンツ=Low-legged hot pants
サイトウ風パンツ=Saitou-style pants
短めプリーツスカートA改=Short pleated skirt A modified
短めボックススカートA改=Short Box Skirt A
腰巻カーディガン並=Waist Wrap Cardigan
腰巻カーディガン広=Wide Waistband Cardigan
腰巻カーディガン広々=Wide Waist Wrap Cardigan
短めフレアスカートＢ改=short flared skirt B modified
プリーツスカート (x1.2)=Pleated Skirts (x1.2)
プリーツスカート (x1.5)=Pleated Skirts (x1.5)
ボックススカート (x1.2)=Box Skirts (x1.2)
ボックススカート (x1.5)=Box Skirts (x1.5)
フレアスカート (x1.2)=Flared Skirts (x1.2)
フレアスカートB ロング=Flared Skirts B Long
フレアスカートB ベリーロング=Flared Skirt B Very Long
フレアスカートB レイヤー=Flared Skirt B Layered
フレアスカートB ロング コルセット=Flared Skirt B Long Corset
フレアスカートB ベリーロング コルセット=Flared Skirt B Belly Long Corset
フレアスカートB レイヤー コルセット=Flared Skirt B Layered Corset
ジーンズもどき=Pseudo Jeans
ジーンズもどき だぼだぼ=Slouchy Jeans
ロングスカート アシンメトリー 左右=Long Skirt Asymmetrical Left/Right
ロングスカート アシンメトリー 前後=Long Skirt Asymmetrical Front/Back
袖ぶかジャージ 下=Sleeve jersey bottom
PCゴシックロリータ スカート=PC Gothic Lolita Skirt
