サキュバスソックス=Succubus Socks
長手袋(L)=Long Glove(L)
長手袋(R)=Long Glove(R)
贵族腰带=Women's waistband
贵族护臂=Noble Armguard
もっとルーズソックス=More Loose Socks
マキノソックス=Makino Socks
ライダーソックス=Rider Socks
アイドルニーソックス2=Idol Knee Socks 2
アイドルニーソックス3=Idol Knee Socks 3
アイドルショルダー=Idol Shoulder
網ニーソックス=Netted Kneesocks
レーナ[86-EIGHTY SIX-]=Raina [86-EIGHTY SIX-]
ネイルチップ（Ｓ）=Nail Tip (S)
ネイルチップ（Ｍ）=Nail Tip (M)
ネイルチップ（Ｌ）=Nail Tip (L)
くいこみニーソ=Kumikomi Knee Socks
くいこみサイハイ=KIKUMI SAI HIGH
左ハイサイ=High Side L
左ニーソ=Knee-Sock L
左ハイソ=High-Sock L
右ニーソ=Knee-Sock R
右ハイソ=High-Sock R
ガーターサイハイ_オーロラAL=Garter sigh high_Aurora AL
ニーソ_嵐燐結騎=Knee Socks_Arashi Rin Yuki
ロークルー=Low Crew
クルー=Crew
スリークォーター=Three Quarters
サンタ=Santa Claus
wen妖精=wen Fairy
パフトショルダー 小=Puffed Shoulder Small
パフトショルダー 3c=Puffed Shoulder 3c
パフトショルダー=Puffed shoulder
襟 1=Collar 1
襟 2=Collar 2
襟 3=Collar 3
くいこみニーハイ 1=Knee High 1
くいこみニーハイ 2=Knee highs 2
汁1=Juice 1
汁2=Juice 2
汁3=Juice 3
汁4=Juice 4
騎士のソックス[マスク変更]=Knight's socks [mask change].
長めのニーソ=Longer Knee Socks
長めのニーソ 二色分け=Longer Knee Socks Two-Color
長めのニーソ 網=Longer Knee Socks Net
ショートパンツ=Short Pants
ホットパンツ=Hotpants
