乃愛=Noa
猫ランジェリー=Cat Lingerie
あんせサンシャインTシャツ=Anse sunshine T-shirt
あんせ裾結びTシャツ=Anse hem knot t-shirt
あんせ裾結びTシャツ(透明)=Safety T-shirt (transparent)
ヴァルキリーアーマー=Valkyrie Armor
聖女の衣=Saint's robe
盗賊の上着(男)=Bandit's jacket (male)
サキュバススーツ=Succubus Suit
ネクロマンサーローブ=Necromancer Robe
亀甲縛り改1=Tortoise Shell Binding Kai 1
亀甲縛り改2=Tortoise Shell Binding Kai 2
体操服In=Gym Uniform In
体操服In透けA=Gym Uniform In Transparent A
体操服In透けB=Gym Uniform In Transparent B
体操服=Gym Uniform
体操服改透けA=Transparent Gym Uniform A
体操服改透けB=Transparent Gym Uniform B
長体操服1=Long Gym Uniform 1
長体操服1透けA=Long Gym Uniform 1 Transparent A
長体操服1透けB=Long Gym Uniform 1 Transparent B
工装=Engineering Equipment
长袖衬衣(男)=Long-sleeved polo shirt (for men)
休闲西装=Casual Western Apparel
AA1衬衣=AA1 Shirt
HS2贵族风衣=HS2 Dress
短袖衬衣(男)=Short-sleeved Shirt (Male)
男西装(领色固定)=Men's suit (fixed collar color)
男西装(腰带)=Western-style dress (waistband)
HS外穿衬衣=HS polo shirt
男T恤(鸡心领)=Men's T-shirt (sweetheart collar)
男棒球服(外)=Man's ball gown (outer)
HS2男衬衣=HS2 polo shirt for men
HS2男马甲=HS2 men's marsupial
衬衣牛仔裤=Shirt polo
闪轨军装=Flashback Channel
三等官ひも=Third class police uniform
チライトップス=Chillie Tops
ガンツスーツアウター=Gantz Suit Outerwear
ガンツスーツアウター2=Gantz Suit Outerwear 2
ガンツスーツアウター3=Gantz suit outerwear 3
逗子総合=Zushi General
ジャージ2(フィット)=Jersey 2 (Fitted)
ジャージ2(スカート)=Jersey 2(Skirt)
マキノジャケット=Makino Jacket
ミロアウター=Milo Outerwear
タンクトップ=Tank Top
ムーTシャツ=Mu T-Shirt
レースアップキャミソール=Lace-up Camisole
ライダーワンピース=Rider Dress
シノンジャケット=Sinon Jacket
衛士強化装備=Pilot Fortified Suit
ランニングウェアA=Running wear A
ランニングウェアB=Running wear B
スウェットA=Sweatshirt A
DALI临时MOD=DALI Temporary MOD
キャミソール(下乳)=Camisole(lower breast)
キャミソール(maskless)=Camisole(maskless)
キュートナース服=Cute Nurse Outfit
衣服=Clothing
セクシーランジェリー（上）=Sexy Lingerie (Top)
軍服2 =Military uniform 2
コルセットのみ=Corset only
ジャージ前開き=Open Jersey
カーディガン無し=No cardigan
ベビードール ツヤ有り=Baby doll with luster
長袖シャツ=Long Sleeve Shirt
ワンピース（インナーなし）=One-piece (without inner wear)
セーラーワンピース改=Sailor Dress modified
裸コート=Bare Coat
裸コート(ベルトなし)=Naked coat (no belt)
ベビードール(ブラ可)=Baby doll (bra allowed)
ランニングウェア（ブラ可）=Running wear(bra allowed)
キャミソール(谷間改)=Camisole(cleavage revision)
スーツ (スカート対応)=Suits (Skirts allowed)
裸エプロン(透過なし)=Naked apron (no transparency)
騎士の鎧[アリス]=Knight's armor [Alice]
ビキニアーマー[アリス]=Bikini Armor [Alice][SAO
ビキニアーマー[アリス][SAO]=Bikini Armor [Alice][SAO]
透過全身タイツ VerA=Transparent Full Length Tights Ver.
透過全身タイツ VerB=Transparent Full-Body Tights Ver.
疑似ヌルテカボディ=Pseudo-slippery body
さらしショート無地=Sarashi Short Plain
HMナース服 verA=HM nurse's uniform verA
HMナース服 verB=HM nurse suit verB
亀甲縛り=Tortoise Shell Binding
紗霧=Sagiri
着ぐるみパジャマ１=Stuffed pajamas 1
着ぐるみパジャマ２=Stuffed pajamas 2
着ぐるみパジャマ３=Stuffed pajamas 3
着ぐるみパジャマ４=Stuffed pajamas 4
クリーム=Cream
ローソンコラボトップス=Lawson collaboration tops
ローソンコラボトップスのみ=LAWSON collaboration tops only
ローソン制服=LAWSON Uniform
パーティートップ=Party Top
ポロシャツ IN=Polo Shirt IN
ポロシャツ OUT=Polo Shirt OUT
冴えカノ冬服=Saekano Winter Wear
冴えカノ夏服=Saekano Summer Wear
忍=Shinobu
忍 花魁=Shinobi Courtesan
ハイネックニットワンピース=High Neck Knit Dress
Vネックニットワンピース=V-Neck Knit Dress
ノースリーブニットワンピース=Sleeveless Knit Dress
肩出しニット=Bare Shoulder Knit Dress
肩出しVネックニット=V-neck knit dress with bare shoulders
オフショルダーブラウス1=Off-the-shoulder Blouse 1
オフショルダーブラウス2=Off-the-shoulder Blouse 2
ハイレグバニー=High-Legged Bunny
ハイレグバニー ツヤ=High-Leg Bunnies Glossy
小悪魔トップス ショルダーレス=Small Devil Tops Shoulderless
ワンピース フリルレス=Dress Frillless
着物1=Kimono 1
着物2=Kimono 2
ドレス風1=Dress style 1
ドレス風2=Dress Style 2
結びTシャツ=Knotted T-Shirt
結びTシャツ 透け=Knotted Tee Transparent
ベビードール=Babydoll
ベビードール オープン=Baby Doll Open
クリスマスポンチョ=Christmas Poncho
クリスマスケープ=Christmas cape
襟立てフリルブラウス=Ruffled Blouse with Collar
りんりんブラウス=Rin Rin Blouse
ファーコート=Fur Coat
キャミソール (クロップド ファック ドール)=Camisole (cropped) (fuck doll)
キャミソール (クロップド)=Camisole (cropped)
ワンピース_オーロラAL=One Piece_Aurora AL
ワンピース_オーロラAL_非武装=One Piece_Aurora AL_Unarmed
ローブ_エデンVB=Robe_Eden VB
ワンピース_嵐燐結騎=One Piece Arashi Rinkouki
ワンピース_嵐燐結騎_プラグイン無=One Piece_Arashi Rinkouki_without Plug-in
エイリークトップ=Eirik Top
멜빵 청바지=빵청바지
멜빵 청바지 (많이 젖음)=멜빵청바지 (많_젖음)
ワンピース 改A=One Piece Revision A
ワンピース 改B=One Piece Mod B
ワンピース 改C=One Piece Modification C
ワンピース 改D=One Piece Modification D
金ボタンジャケット(男)=Gold Button Jacket(Man)
軍服=Military Uniform
王子服=Prince Uniform
サンタ=Santa Claus
セーラーシャツ(男)=Sailor Shirt (Boys)
セーラーノースリーブ(男)=Sleeveless Sailor (Boys)
wen立华奏=wen liyuan
wen妖精=wen Fairy
wen夜夜=WEN Night Night
ネクタイブレザー(男)- fix=Necktie Blazer (Male) - fix
ネクタイブレザー[ボタン変更]- fix=Tie Blazer [Button Change]-fix
ハイレグバニーH_A（襟op）=High-Legged Bunny H_A (collar op)
ハイレグバニーH_B（襟op）=High-Legged Bunny H_B (Collar op)
ハイレグバニー（重ね着用/襟op）=High-Legged Bunny (Overlapping / Collar op)
ボートネックTシャツ（裾短）=Boat Neck T-Shirt (Short Hem)
ダボTシャツ=Dabo T-shirt
ダボTシャツ（透け）=Dabo T-shirt (Transparent)
ダボＴシャツ（透け柄）=Dabo T-shirt (transparent pattern)
童殺セーター（～普乳）=Child killer sweater (~normal tits)
童殺セーターＨ（～普乳）=Sweater H（Big Tits
童殺セーター（巨乳）=Child killer sweater (Big tits)
童殺セーターＨ（巨乳）=Child killer sweater H (Big tits)
エジプト風胸飾り=Egyptian-style chest ornament
前垂れセーター=Front-hanging sweater
前垂れセーター（胸張り中）=Sweater with drooping front (medium chest)
前垂れセーター（胸張り大）=Sweater with drooping front (large chest)
下乳セーター=Sweater with lower breast
下乳セーター（胸張り）=Lower Breast Sweater (Full Breasted)
ミニチャイナ=Mini China
ミニチャイナＨ=Mini China H
ミニチャイナＳｅｐ=Mini China Sep
ミニチャイナ（裾色変え可）=Mini China (Hem Color Changeable)
ミニチャイナＨ（裾色変え可）=Mini China H (Hem color can be changed)
ミニチャイナＳｅｐ（裾色変え可）=Mini China Sep (hem color changeable)
ジムリーダー風シャツ=Gym Leader Style Shirt
すけレースドレス01=Suke-Lace Dress 01
すけレースドレス01胸あけ=Suke-Lace Dress 01 (open chest)
すけレースドレス01v2=Transparent-Lace Dress 01v2
すけレースドレス01v2胸あけ=Transparent-Lace Dress 01v2 Open-Breasted
すけすけキャミソール=Sukesuke Camisole
ボートネックTシャツ=Boat-neck T-shirt
立て襟ワンピース=Standing Collar Dress
改造 Tシャツ=Modified T-Shirt
改造 Tシャツ 開=Modified T-Shirt Open
改造 Tシャツ2=Modified T-Shirt 2
改造 Yシャツ=Modified Y-Shirt
改造 Yシャツ 開=Modification Y Shirt Open
改造 インナー=Modification Innerwear
改造 パジャマ1=Modification Pajamas 1
改造 パジャマ1 開=Pyjamas 1 Open
改造 パジャマ2=Modified Pajamas 2
改造 パジャマ2 開=Modification Pajamas 2 Open
ノースリーブ アレンジ 短=Sleeveless Arrange Short
ハロウィントップス op削除1=Halloween Tops op deleted1
ハロウィントップス op削除2=Halloween Tops op deleted2
長袖 in=Long sleeves in
長袖 out=Long sleeves out
タートルネック in=Turtleneck in
タートルネック out=Turtleneck out
タートルネック パフスリーブ in=turtleneck with puff sleeves in
タートルネック パフスリーブ out=Turtleneck with puff sleeves out
タートルネック ジャケット =Turtleneck Jacket
タートルネック 胸元空き=Turtleneck open at chest
タートルネック パフスリーブ 胸元空き=Turtleneck Puffed sleeves open at chest
長袖 ベルスリーブ=Long Sleeve Bell Sleeve
長袖 ベルスリーブ 開=Long Sleeve Bell Sleeve Open
タートルネック 白衣=Turtleneck White Jacket
タートルネック 白衣 ベルトなし=Turtleneck White Coat Without Belt
ジャケット ラフ=Jacket Rough
ジャケット ラフ + チア=Jacket Ruff + Cheerleader
ジャケット ラフ + バニー=Jacket Ruff + Bunny
ジャケット ラフ + バンドゥビキニ=Jacket Ruff + Bandeau bikini
ジャケット 短 + バンドゥビキニ=Jacket short + bandeau bikini
チューブワンピース もどき=Tube One Piece Prototype
チューブワンピース もどき プロトタイプ=Tube One Piece Prototype
袖ぶかパーカー=Hoodie with short sleeves
袖ぶかパーカー ヘソだし=Hoodie with sleeves and bare belly button
袖ぶかジャージ 上=Sleeve jersey top
[PC]私服(紅葉)=PC] plain clothes (Momiji)
[PC]私服(朝江)=[PC] plain clothes (Asae)
[PC]私服(弥生)=[PC] plain clothes (Yayoi)
[PC]私服(弥生) retake=[PC]plain clothes (Yayoi) retake
[PC]軍服=[PC]military uniform
[PC]ゴシックロリータ=[PC]Gothic Lolita
[HS][男性]Yシャツ=[HS][Male] Y-shirt
[HS][男性]Tシャツ=[HS][Male] T-shirt
[HS][男性]ランニングシャツ=[HS][Male] Running Shirt
[HS][男性]タンクトップ=[HS][Men] Tank Tops
[HS][男性]長袖Tシャツ=[HS][Men] Long Sleeve T-Shirt
[HS][男性]レイヤードパーカー=[HS][Men] Layered Hoodie
[HS][男性]ジェントルスーツ=[HS][Men] Gentle Suit
[HS][男性]ベスト=[HS][Men] Vest
[HS][男性]フードパーカー=HS][Men] Hooded Hoodie
[HS]ヒーロースーツ=[HS][Hero Suit
[HS]ブタスーツ=[HS][Pig] suit
[HS]ドルフくんスーツ=[HS]Dolph suit
ネクタイブレザー[ボタン変更]=Necktie blazer [change button].
騎士のスーツ[金具銀]=Knight's suit [silver].
騎士のスーツ[金具黒]=Knight's suit[Black].
騎士のスーツ[金具色指定]=Knight's suit[change color].
アイドルワンピ[マスク変更]=idol onesie[change mask]
濡れT=Wet T
濡れT 薄=Wet T Thin
騎士のスーツ[アレンジ]=Knight's suit[arrange].
セクシーパレオ[均一透過]=Sexy pareo[Uniform transparency].
セクシーパレオ[透過なし]=Sexy pareo[No transparency].
乳袋Tシャツ=Breast pouch T-shirt
乳袋Tシャツショート=Breast Bag Tee Short
乳袋Tシャツミニ=Mini Breast Bag Tee
乳テントTシャツ=Breast Tent Tee
乳テントTシャツショート=Tummy Tee Short
乳テントTシャツミニ=Tshirt Mini
ほのかTシャツ（モーモちゃん）=Honoka T-Shirt (Momo-chan)
ほのかTシャツ（無地）=Honoka T-Shirt (Plain)
透けほのかTシャツ（モーモちゃん）=Transparent Honoka T-shirt (Momo-chan)
透けほのかTシャツ（無地）=Transparent Honoka T-shirt (plain)
