クレアブレザー=Claire Blazer
[Add]弓道衣胸当てなし=Add] Kyudo Kimono without Breastplate
[Add]スーツ=[Add] suit
[Add]ノースリーブワンピース=[Add] Sleeveless dress
[Add]パーカー前開き=Add] Hoodie with front opening
[Add]ワンピース（無地）=Add] dress (plain)
あんせ長袖ワンピ=Anse long-sleeved one-piece
あんせサスペンダー ロング=Safety suspenders long
あんせサスペンダー ショート=Safety suspenders short
あんせレインコート=Safety raincoat
男背带=men's back strap
贵族短风衣=Short-Sleeved Shirt
立领制服=Stand-up collar uniform
男学生服=Men's school uniform
男背心短袖衬衣=Men's polo shirt with short sleeves
HS2男马甲=HS2 men's marsupial
男学生背心衬衣=Men's polo shirt
闪轨本校制服=Internal channels
黎恩服饰(下摆)=Li En clothing (hem)
黎恩服饰(固定)=Li En clothing (regular)
谷間カーディガン=Cleavage Cardigan
ブレザーC改=Blazer C
マインマント=Mine Cloak
ミライアカリ=Mariah Carey
乙倉アウター=Otokura Outerwear
遠坂コート=Tohsaka Coat
スウィート・パティシエール=Sweet Patissiere
パーカー前開き=Open Parka
アイドルおなか=Idol Tummy
半開きパーカー=Partially-Open Parka
整合騎士の鎧[アリス][SAO]=Matching Knight's Armor [Alice][SAO]
創世神ステイシア[SAO]=God of Creation Stacia [SAO][SAO
地神テラリア[SAO]=Earth God Terraria [SAO].
シノン(ケットシー)[SAO]=Sinon(Ketsee)[SAO][SAO
太陽神ソルス[SAO]=Solus, God of the Sun[SAO].
レーナ[86-EIGHTY SIX-]=Raina [86-EIGHTY SIX-]
だぼパーカー(スカート)=Draped Parka (Skirt)
だぼパーカー(フィット)=Draped Parka (Fitted)
だぼパーカー腕まくり(スカート)=Draped Parka w\ rolled up sleeves (Skirt)
だぼパーカー腕まくり(フィット)=Draped Parka w\ rolled up sleeves (Fitted)
だぼパーカー萌袖(スカート)=Draped Parka w\ cute sleeves (Skirt)
だぼパーカー萌袖(フィット)=Draped Parka w\ cute sleeves (Fitted)
だぼカーディガン=Draped Cardigan
ブレザーC(inmab改)=Blazer C(inmab modified)
長袖ブレザーC前開き=Long Sleeve Blazer C Front Opening
ロングカーディガン前開き=Long Cardigan Front Opening
ベスト=Vest
ロングパーカー１=Long Hoodie 1
ロングパーカー２=Long Hoodie 2
ノースリーブロングパーカー=Sleeveless Long Hoodie
萌え袖ロングパーカー１=Moe Sleeve Long Hoodie1
萌え袖ロングパーカー２=Moe Sleeve Long Hoodie2
ジャンパースカート=Jumperskirt
ジャンパースカート_himiko=Jumperskirt-himiko
ジャンパースカート-may=Jumperskirt-may
ジャンパースカート-melt=Jumperskirt-melt
ジャンパースカート-merline=Jumperskirt-merline
乳袋ジャケット=breast bag jacket
乳袋ジャケット 袖無し=breast bag jacket without sleeves
コルセット=Corset
カーディガン=Cardigan
ロングカーディガン=Long Cardigans
ジャケット=Jacket
セーター=Sweater
キャミソール=Camisole
カーディガン_djeeta=Cardigans-djeeta
ファーコート=Fur Coat
ファーコート-hallessena=Fur coat-hallessena
ベーシックコート=Basic Coat
トレンチコート=Trench Coat
ワンピコート=One-piece Coats
ノースリーブワンピ=Sleeveless Onesie
キーホールワンピ=Keyhole Onesies
ベアワンピ=Bare One-Piece
ベアワンピ（レザー）=Bare One-Piece (Leather)
ノースリーブトップス（スレンダー）=Sleeveless Tops (Slender)
ノースリーブトップス（グラマー）=Sleeveless Tops (Glamour)
ベスト（スレンダー）=Vest (Slender)
ベスト（グラマー）=Vest(Glamour)
ライダース（スレンダー）=Riders(Slender)
ライダース（グラマー）=Riders (Glamour)
腰巻カーディガン並=Waist Wrap Cardigan
腰巻カーディガン広=Wide Waistband Cardigan
腰巻カーディガン広々=Wide Waist Wrap Cardigan
ジャンパースカートもどき=Jumperskirt
ジャンパースカートもどき 2=Jumperskirt 2
