タイプい=Type い
タイプろ=Type ろ
タイプは=Type は
タイプに=Type に
タイプほ=Type ほ
タイプへ=Type へ
タイプと=Type と
タイプち=Type ち
タイプ１（下唇のみ）=Type 1 (Lower Lip Only)
タイプ２（下唇のみ）=Type 2 (Lower Lip Only)
タイプ３（下唇のみ）=Type 3 (Lower Lip Only)
タイプ４（下唇のみ）=Type 4 (Lower Lip Only)
タイプ５（下唇のみ）=Type 5 (Lower Lip Only)
タイプ６（下唇のみ）=Type 6 (Lower Lip Only)
タイプ７（下唇のみ）=Type 7 (Lower Lip Only)
タイプ８（下唇のみ）=Type 8 (Lower Lip Only)
タイプＡ=Type A
タイプＢ=Type B
タイプＣ=Type C
タイプＤ=Type D
タイプＥ=Type E
タイプＦ=Type F
タイプＧ=Type G
タイプＨ=Type H
タイプＩ=Type I
タイプＪ=Type J
タイプＫ=Type K
タイプＬ=Type L
タイプＭ=Type M
タイプＮ=Type N
